,0,1,2,3,4,5,6,7,8,9
0,S,P,P,P,P,P,P,P,P,P
1,P,T,E,P,E,E,P,E,E,P
2,P,T,E,P,E,E,P,E,E,P
3,P,E,E,P,E,E,P,E,E,P
4,P,E,E,P,E,E,P,E,E,P
5,P,E,E,P,E,E,P,E,E,P
6,P,E,E,P,E,E,P,E,E,P
7,P,E,E,P,E,E,P,E,E,P
8,P,E,E,P,E,E,P,E,E,P
9,P,E,E,P,E,E,P,E,E,P
10,P,P,P,P,P,P,P,P,P,P
